5
0 2 2 1 1
2 3 4 2 7
2 1 2 8 1
1 1 3 2 1
2 6 2 4 5
